1111111111111
10010000000C1
1000000011001
101P11E000001
1111111111111